
      7-------8
      [p##r###]
      [#######]
      [##b#b##]
      [r##b##r]
      [##b#b##]
      [#######]
      [d##r##e]
      5_______6
