

         [t]
      7--3#4--8
      [#b#####]
      [##r#r##]
      [###p###]
      [#b####d]
      5__1#2__6
         [t]

